{
  "id": 10,
  "player": [5, 1],
  "board": [
    ["#", "#", "#", "#", "#", "#", "#", "#", "#", "#", "#", "#"],
    ["#", ".", ".", ".", ".", ".", ".", ".", "#", ".", "G", "#"],
    ["#", ".", ".", ".", ".", ".", ".", ".", "#", ".", ".", "#"],
    ["#", ".", ".", ".", ".", ".", ".", ".", "#", "#", ".", "#"],
    ["#", ".", ".", ".", ".", ".", ".", ".", ".", "#", ".", "#"],
    ["#", ".", ".", ".", ".", ".", ".", ".", ".", "W", ".", "#"],
    ["#", ".", ".", ".", ".", ".", ".", ".", ".", ".", ".", "#"],
    ["#", ".", ".", ".", ".", ".", ".", ".", ".", ".", ".", "#"],
    ["#", ".", ".", ".", ".", "L", ".", ".", ".", ".", ".", "#"],
    ["#", ".", ".", ".", ".", ".", ".", ".", ".", ".", ".", "#"],
    ["#", "W", ".", ".", ".", ".", ".", ".", ".", ".", ".", "#"],
    ["#", "#", "#", "#", "#", "#", "#", "#", "#", "#", "#", "#"]
  ],
  "state": "playing"
}
