{
  "id": 8,
  "player": [6, 7],
  "board": [
    ["#", "#", "#", "#", "#", "#", "#", "#", "#", "#", "#", "#"],
    ["#", ".", ".", ".", ".", ".", ".", ".", ".", ".", "G", "#"],
    ["#", ".", "#", ".", ".", ".", ".", "#", ".", ".", ".", "#"],
    ["#", ".", ".", ".", ".", ".", ".", ".", ".", ".", ".", "#"],
    ["#", ".", ".", ".", "#", ".", ".", ".", ".", ".", ".", "#"],
    ["#", ".", ".", ".", ".", ".", "#", ".", ".", ".", ".", "#"],
    ["#", ".", ".", ".", ".", ".", ".", ".", ".", ".", ".", "#"],
    ["#", ".", ".", ".", ".", ".", ".", ".", ".", ".", ".", "#"],
    ["#", ".", ".", ".", ".", "L", ".", ".", ".", ".", ".", "#"],
    ["#", "W", ".", ".", ".", ".", "B", ".", ".", ".", ".", "#"],
    ["#", ".", ".", ".", ".", ".", ".", ".", ".", ".", ".", "#"],
    ["#", "#", "#", "#", "#", "#", "#", "#", "#", "#", "#", "#"]
  ],
  "state": "playing"
}
