{
  "id": 9,
  "player": [5, 8],
  "board": [
    ["#", "#", "#", "#", "#", "#", "#", "#", "#", "#", "#", "#"],
    ["#", ".", ".", ".", ".", ".", ".", ".", ".", ".", "G", "#"],
    ["#", ".", "#", ".", ".", ".", ".", "#", ".", ".", ".", "#"],
    ["#", ".", ".", ".", ".", ".", ".", ".", ".", "B", ".", "#"],
    ["#", ".", ".", ".", "#", ".", ".", ".", "B", ".", ".", "#"],
    ["#", ".", ".", ".", ".", ".", "#", "B", ".", ".", ".", "#"],
    ["#", ".", ".", ".", ".", ".", ".", ".", ".", ".", ".", "#"],
    ["#", ".", ".", ".", ".", ".", ".", ".", ".", ".", ".", "#"],
    ["#", ".", ".", ".", ".", "L", ".", ".", ".", ".", ".", "#"],
    ["#", "W", ".", ".", ".", ".", ".", ".", ".", ".", ".", "#"],
    ["#", ".", ".", ".", ".", ".", ".", ".", ".", ".", ".", "#"],
    ["#", "#", "#", "#", "#", "#", "#", "#", "#", "#", "#", "#"]
  ],
  "state": "playing"
}
