{
  "id": 3,
  "player": [10, 2],
  "board": [
    ["#", "#", "#", "#", "#", "#", "#", "#", "#", "#", "#", "#"],
    ["#", ".", ".", ".", ".", ".", ".", ".", ".", ".", "G", "#"],
    ["#", ".", ".", ".", ".", ".", ".", ".", ".", ".", ".", "#"],
    ["#", ".", ".", ".", ".", ".", ".", ".", ".", "W", ".", "#"],
    ["#", ".", ".", ".", ".", ".", ".", ".", ".", ".", ".", "#"],
    ["#", ".", ".", ".", ".", ".", ".", ".", ".", ".", ".", "#"],
    ["#", ".", ".", ".", ".", ".", ".", ".", ".", ".", ".", "#"],
    ["#", ".", ".", ".", ".", ".", ".", ".", ".", ".", ".", "#"],
    ["#", ".", ".", "B", ".", ".", ".", ".", ".", "L", ".", "#"],
    ["#", ".", ".", ".", ".", ".", ".", ".", ".", ".", ".", "#"],
    ["#", ".", ".", ".", ".", ".", ".", ".", ".", ".", ".", "#"],
    ["#", "#", "#", "#", "#", "#", "#", "#", "#", "#", "#", "#"]
  ],
  "state": "playing"
}
