{
  "id": 4,
  "player": [9, 3],
  "board": [
    ["#", "#", "#", "#", "#", "#", "#", "#", "#", "#", "#", "#"],
    ["#", ".", ".", ".", ".", ".", ".", ".", ".", ".", "G", "#"],
    ["#", ".", "#", ".", ".", ".", ".", "#", ".", ".", ".", "#"],
    ["#", ".", ".", ".", ".", "W", ".", ".", ".", ".", ".", "#"],
    ["#", ".", "#", ".", ".", ".", ".", ".", "#", ".", ".", "#"],
    ["#", ".", ".", ".", ".", ".", ".", ".", ".", ".", ".", "#"],
    ["#", ".", ".", ".", ".", ".", ".", ".", ".", ".", ".", "#"],
    ["#", ".", ".", "#", ".", ".", ".", ".", ".", ".", ".", "#"],
    ["#", ".", ".", ".", ".", "L", ".", ".", "#", ".", ".", "#"],
    ["#", ".", ".", ".", ".", ".", ".", ".", ".", ".", ".", "#"],
    ["#", ".", ".", ".", "B", ".", ".", ".", ".", ".", ".", "#"],
    ["#", "#", "#", "#", "#", "#", "#", "#", "#", "#", "#", "#"]
  ],
  "state": "playing"
}
