{
  "id": 7,
  "player": [7, 6],
  "board": [
    ["#", "#", "#", "#", "#", "#", "#", "#", "#", "#", "#", "#"],
    ["#", ".", ".", ".", ".", ".", ".", ".", ".", ".", ".", "#"],
    ["#", ".", "#", ".", ".", ".", ".", ".", ".", ".", ".", "#"],
    ["#", ".", ".", ".", ".", ".", ".", ".", ".", ".", ".", "#"],
    ["#", ".", ".", ".", "#", ".", ".", ".", ".", ".", ".", "#"],
    ["#", ".", ".", ".", ".", ".", "#", ".", ".", ".", ".", "#"],
    ["#", ".", ".", ".", ".", ".", ".", ".", ".", ".", ".", "#"],
    ["#", ".", ".", ".", ".", ".", ".", ".", ".", ".", ".", "#"],
    ["#", ".", ".", ".", "L", ".", ".", ".", ".", ".", "G", "#"],
    ["#", ".", ".", ".", ".", ".", ".", ".", ".", ".", ".", "#"],
    ["#", "W", ".", ".", ".", ".", ".", "B", ".", ".", ".", "#"],
    ["#", "#", "#", "#", "#", "#", "#", "#", "#", "#", "#", "#"]
  ],
  "state": "playing"
}
